You have an hour to find the clues, solve the puzzles, and break out of the room. Be sure to examine everything to find clues. Your friend is along for the ride, but is very tired and not much help. He'll end up sleeping for most of the hour.

The main room is divided in to four parts, "NE, NW, SE, and SW". You can't walk diagonally between these zones, so navigate in the main room using: "N, S, E, W". (ex. moving from NE to SW, use S and then W or W and then S. The upper left of the status bar will help by letting you know what directions you can walk in. A door called "Exit Door" is the final puzzle to escape the room and win.

The employee takes you in to the NE zone of the room and the time begins.

Escape!
An interactive fiction escape room by Brent Scott
Release 1 / Serial number 190422 / Inform 7 build 6M62 (I6/v6.33 lib 6/12N) SD

NE Zone
In this side of the room there is a painting hanging and the exit door, with its flashing keypad. (Examine the exit door to enter pin code)

You can see Exit Door and Wall Clock here.

>SW
You can't go that way.

You have 60 minutes to breakout! (Each turn is one minute)

>s
SE Zone
You can see Closet Door here.

>w
SW Zone

* * *

>e
(first opening Exit Door)
It seems to be locked.

You have 60 minutes to breakout! (Each turn is one minute)

>w
NW Zone
{describe here} there is a small poster with bold print on the wall

You can see Desk and Poster here.

I beg your pardon?

* * *

>w
NW Zone
{describe here} there is a small poster with bold print on the wall

You can see Desk and Poster here.

>w
You can't go that way.

* * *

>examine painting
A large abstract blue painting hung solidly in place

You have 60 minutes to breakout! (Each turn is one minute)

>w
NW Zone
In this side of the room there is a desk and with a small poster with bold hanging above it

You can see Desk here.

>x desk
There's not much on the desk surface other than a lamp. The desk has a small drawer below it.

>open drawer
You can't see any such thing.

* * *

>look at painting
You can't see any such thing.

* * *

>s
SE Zone
In this side of the room there is a painting hanging and a small closet with an interesting locked door.

You can see Closet Door here.

You have 60 minutes to breakout! (Each turn is one minute. You will be reminded periodically of the time, or you can always examine the wall clock in the NE zone.)

>n
NE Zone
In this side of the room there is a painting hanging and the exit door, with its flashing keypad. (x Exit Door to enter pin code)

You can see Exit Door and Wall Clock here.

>w
NW Zone
In this side of the room there is a desk with a small poster hanging above it

You can see Desk here.

>open desk drawer
You open Desk Drawer, revealing Paperclip.

>take paperclip
Taken.

>unfold paperclip
You unfold the paperclip in to a long, stiff wire, making it perfect to pick a door

>s
SW Zone
In this side of the room there is a painting hanging and your friend is sleeping on the floor.

You can see Hidden Door, Red Painting and Friend here.

>w
(first opening Hidden Door)
It seems to be locked.

>e
SE Zone
In this side of the room there is a painting hanging and a small closet with an interesting locked door.

You can see Closet Door here.

>unlock closet door
(with Paperclip)
You unlock Closet Door.

>s
(first opening Closet Door)
You use the long wire of the unfolded paperclip to pick the lock on the door. It clicks and the door is unlocked. 
Closet
A small closet with a few jackets hung on the bar

You can see Closet Door, Suede Jacket, Leather Jacket and Cotten Jacket here.

>x cotten jacket
A trendy white bomber jacket made out of cotten. There is a zipped pocket on the front of this jacket

>x pocket
you open the Jacket pocket, revealing Unidentified Key

>take key
Taken.

* * *

>n
NE Zone
In this side of the room there is a painting hanging and the exit door, with its flashing keypad. (x Exit Door to enter pin code)

You can see Exit Door and Wall Clock here.

>x wall clock
A digital clock showing the current time. You started the game at 9:00 am and have 60 minutes to escape. Remember that each turn is one minute.
it is currently 9:02 am

* * *

>s
SE Zone
In this side of the room there is a painting hanging and a small closet with an interesting locked door.

You can see Closet Door here.

You have 60 minutes to breakout! (Each turn is one minute. You will be reminded periodically of the time, or you can always examine the wall clock in the NE zone.)

>open closet door
The door is locked. If only you had something to manipulate the lock open.

>e
You can't go that way.

>w
SW Zone
In this side of the room there is a painting hanging and your friend is sleeping on the floor.

You can see Hidden Door and Friend here.

>n
NW Zone
In this side of the room there is a desk with a small poster hanging above it

You can see Desk here.

>open desk drawer
You open Desk Drawer, revealing Paperclip.

* * *

>unfold paperclip
You unfold the paperclip in to a long, stiff wire, making it perfect to pick a door

>s
SW Zone
In this side of the room there is a painting hanging and your friend is sleeping on the floor.

You can see Hidden Door and Friend here.

>e
SE Zone
In this side of the room there is a painting hanging and a small closet with an interesting locked door.

You can see Closet Door here.

>open closet door
You use the long wire of the unfolded paperclip to pick the lock on the door. It clicks and the door is unlocked.

>enter closet
(first opening Closet Door)
You use the long wire of the unfolded paperclip to pick the lock on the door. It clicks and the door is unlocked.

>x closet
An ordinary door leading to a small storage closet in the room. It's locked with one of those flimsy locks the criminals always pick.

>w
SW Zone
In this side of the room there is a painting hanging and your friend is sleeping on the floor.

You can see Hidden Door and Friend here.

>w
(first opening Hidden Door)

Hidden Room
You can see Hidden Door and Computer here.

>x computer
Logging in...
...
...
A line of numbers appears on the screen: {7692649}
You have 45 minutes left to break out!

>x computer
Logging in...
...
...
A line of numbers appears on the screen: {7692649}

>e
SW Zone
In this side of the room there is a painting hanging and your friend is sleeping on the floor.

You can see Hidden Door and Friend here.

>e
SE Zone
In this side of the room there is a painting hanging and a small closet with an interesting locked door.

You can see Closet Door here.

>n
NE Zone
In this side of the room there is a painting hanging and the exit door, with its flasking keypad.

You can see Exit Door here.

>x exit door
A solid metal door and keypad. Have you found the pin code?

Enter the 4 digit pin code to unlock door.

>6264
**BUZZ**  The door unlocks

>open door
You open Exit Door.

>e
Lobby
You can see Exit Door here.

* * *

>s
SE Zone
In this side of the room there is a painting hanging and a small closet with an interesting locked door.

You can see Closet Door here.

You have 60 minutes to breakout! (Each turn is one minute. You will be reminded periodically of the time, or you can always examine the wall clock in the NE zone.)

>w
SW Zone
You can see Hidden Door here.

>w
(first opening Hidden Door)

Hidden Room
You can see Hidden Door and Computer (closed) here.

>x computer
You see nothing special about Computer.

>open computer
Logging in...
A matrix of numbers appears on the screen. 1 2 3 4 5 6 7 8 9 1 2 3 4 4 6 7

* * *

>w
NW Zone
In this side of the room there is a desk with a small poster hanging above it

You can see Desk here.

You have 60 minutes to breakout! (Each turn is one minute)

>e
Lobby
You can see Exit Door here.

>w
NE Zone
You can see Exit Door here.

>w
You can't go that way.

>e
Lobby
You can see Exit Door here.

* * *

>w
You can't go that way.

>s
SE Zone
You can see Closet Door here.

>w
You can't go that way.

* * *

>w
NW Zone
In this side of the room there is a desk with a small poster hanging above it

You can see Desk here.

You have 60 minutes to breakout! (Each turn is one minute)

>open desk drawer
You open Desk Drawer, revealing Paperclip.

>look in desk drawer
In Desk_Drawer is Paperclip.

>take paperclip
Taken.

>unfold paperclip
That's not a verb I recognise.

* * *

>open desk drawer
You open Desk Drawer, revealing Paperclip.

>open drawer
You open Desk_Drawer.

* * *

>e
SE Zone
In this side of the room there is a painting hanging and a small closet with an interesting locked door.

You can see Closet Door here.

>open closet door
You use the long wire of the unfolded paperclip to pick the lock on the door. It clicks and the door is unlocked. 
You open Closet Door.

>open closet_door
You use the long wire of the unfolded to pick the lock on the door. It clicks and the door is unlocked. 
*** Run-time problem P10: Since Closet Door is not allowed the property "locked", it is against the rules to try to use it.

* * *

>open closet door
You use the long wire of the unfolded paperclip to pick the lock on the door. It clicks and the door is unlocked. 
You open Closet Door.

>s
Closet
A small closet with a few jackets hung on the bar

You can see Closet Door, Suede Jacket, Leather Jacket and Cotten Jacket here.

>n
SE Zone
In this side of the room there is a painting hanging and a small closet with an interesting locked door.

You can see Closet Door here.

>enter closet
Closet
A small closet with a few jackets hung on the bar

You can see Closet Door, Suede Jacket, Leather Jacket and Cotten Jacket here.

* * *

>w
NW Zone
In this side of the room there is a desk with a small poster hanging above it

You can see Desk here.

You have 60 minutes to breakout! (Each turn is one minute)

>w
NW Zone
You can see Desk Drawer (in which is Paperclip) here.

>take paperclip
Taken.

>s
SW Zone
You can see Hidden Door here.

>e
SE Zone
You can see Closet Door here.

>open closet door
It seems to be locked.

>open closet door with paperclip
You unlock Closet Door.

* * *

>x Exit Door
The final door, leading to the lobby once you escape. It's a solid metal door with a keypad. Have you found the pin code?

You have 60 minutes to breakout! (Each turn is one minute. You will be reminded periodically of the time, or you can always examine the wall clock in the NE zone.)

Enter the 4 digit pin code to unlock door.

>NW
Incorrect pin, Door remains locked.

Would you like to try again? (Yes or No)

* * *

>nw
You can't go that way.

>s
SE Zone
In this side of the room there is a painting hanging and a small closet with an interesting locked door.

You can see Closet Door here.

>s
(first opening Closet Door)
The door is locked. If only you had something to manipulate the lock open.

>w
SW Zone
In this side of the room there is a painting hanging and your friend is sleeping on the floor.

You can see Red Painting and Friend here.

>x Red Painting
A large abstract red painting hanging slightly askew on the wall

>Look behind painting
You can't see any such thing.

>east
SE Zone
In this side of the room there is a painting hanging and a small closet with an interesting locked door.

You can see Closet Door here.

>norht
That's not a verb I recognise.

>north
NE Zone
In this side of the room there is a painting hanging and the exit door, with its flashing keypad. (x Exit Door to enter pin code)

You can see Exit Door and Wall Clock here.

>x Wall clock
A digital clock showing the current time. You started the game at 9:00 am and have 60 minutes to escape. Remember that each turn is one minute.
it is currently 9:08 am

>nw
You can't go that way.

>go w
NW Zone
In this side of the room there is a desk with a small poster hanging above it

You can see Desk here.

>x Desk
There's not much on the desk surface other than a potted plant. The desk has a small drawer below it.

>x small drawer
You can't see any such thing.

>open drawer
You open Desk Drawer, revealing Paperclip.

>take paperclip
Taken.

>s
SW Zone
In this side of the room there is a painting hanging and your friend is sleeping on the floor.

You can see Red Painting and Friend here.

>e
SE Zone
In this side of the room there is a painting hanging and a small closet with an interesting locked door.

You can see Closet Door here.

You have 45 minutes left to break out!

>pick lock
I didn't understand that sentence.

>unlock door
(with Paperclip)
That doesn't seem to fit the lock.

>unfold paperclip
You unfold the paperclip in to a long, stiff wire, making it perfect to pick a door

>unlock door
(with Paperclip)
That doesn't seem to fit the lock.

>open door
You use the long wire of the unfolded paperclip to pick the lock on the door. It clicks and the door is unlocked. 
You open Closet Door.

>go inside closet
Closet
A small closet with a few jackets hung on the bar

You can see Closet Door, Suede Jacket, Leather Jacket and Cotton Jacket here.

>x cotton jacket
A trendy white bomber jacket made out of cotton. There is a zipped pocket on the front of this jacket

>open pocket
You open Jacket pocket, revealing Unidentified key.

>take key
Taken.

>x leather jacket
An emo looking slick black leather jacket.

>x suede jacket
A very fashionable blue suede jacket.

>n
SE Zone
In this side of the room there is a painting hanging and a small closet with an interesting locked door.

You can see Closet Door here.

>w
SW Zone
In this side of the room there is a painting hanging and your friend is sleeping on the floor.

You can see Red Painting and Friend here.

>x painting
A large abstract red painting hanging slightly askew on the wall

>move painting\
You can't see any such thing.

>move painting
Nothing obvious happens.

>x friend
Your friend begrudgingly agreed to come along with you to do the escape room, but is spending most of the time sleeping on the floor. You'll need to WAKE him before he can help you.

You have 30 minutes left to break out!

>wake friend
You wake up your friend. He is now ready to help.

>move painting
Nothing obvious happens.

>tak epainting
That's not a verb I recognise.

>take painting
Taken.

>x hidden door
You can see the faint outline of a door .

>open door
It seems to be locked.

>use key to open door
That's not a verb I recognise.

>use
That's not a verb I recognise.

>unlock door with key
You unlock Hidden Door.

>open door
You open Hidden Door.

>w
Hidden Room
A small dark room with only one thing in it. The computer sits on the floor, plugged in to the wall.

You can see Computer here.

>x computer
Logging in...
...
...
A line of numbers appears on the screen: {7692649}

>e
SW Zone
In this side of the room there is a painting hanging and your friend is sleeping on the floor.

You can see Friend here.

>n
NW Zone
In this side of the room there is a desk with a small poster hanging above it

You can see Desk here.

>x poster
The poster hangs above the desk and reads "ODD NUMBERS ARE A MYTH. Consider only using the even numbers"

>e
NE Zone
In this side of the room there is a painting hanging and the exit door, with its flashing keypad. (x Exit Door to enter pin code)

You can see Exit Door and Wall Clock here.

>x Exit Door
The final door, leading to the lobby once you escape. It's a solid metal door with a keypad. Have you found the pin code?

Enter the 4 digit pin code to unlock door.

>6264
**BUZZ**  The door unlocks

>w
NW Zone
In this side of the room there is a desk with a small poster hanging above it

You can see Desk here.

Congrats! You open the door and escape in time!

    *** The End ***

Would you like to RESTART, RESTORE a saved game, QUIT or UNDO the last command?

* * *

>x door
A solid metal door and keypad. Have you found the pin code?

You have 60 minutes to breakout! (Each turn is one minute)
Enter the 4 digit pin code to unlock door.

>4262
Incorrect pin, Door remains locked.

Would you like to try again? (Yes or No)

>yes
Enter the 4 digit pin code to unlock door.

>6264
**BUZZ**  The door unlocks

>open door
You open Exit Door.

Congrats! You open the door and escape in time!

    *** The End ***

Would you like to RESTART, RESTORE a saved game, QUIT or UNDO the last command?

Please give one of the answers above.

Would you like to RESTART, RESTORE a saved game, QUIT or UNDO the last command?

* * *

>x exit door
The final door, leading to the lobby once you escape. It's a solid metal door with a keypad. Have you found the pin code?

You have 60 minutes to breakout! (Each turn is one minute. You will be reminded periodically of the time, or you can always examine the wall clock in the NE zone.)

Enter the 4 digit pin code to unlock door.

>no
Incorrect pin, Door remains locked.

Would you like to try again? (Yes or No)

* * *

>s
SE Zone
In this side of the room there is a painting hanging and a small closet with an interesting locked door.

You can see Closet Door here.

>x painting
A large abstract green painting hung solidly in place

>x small closet
You can't see any such thing.

>x closet
An ordinary door leading to a small storage closet in the room. It's locked with one of those flimsy locks the criminals always pick.

>n
NE Zone
In this side of the room there is a painting hanging and the exit door, with its flashing keypad. (Examine the exit door to enter pin code)

You can see Exit Door and Wall Clock here.

>x wall clock
A digital clock showing the current time. You started the game at 9:00 am and have 60 minutes to escape. Remember that each turn is one minute.
it is currently 9:05 am

>s
SE Zone
In this side of the room there is a painting hanging and a small closet with an interesting locked door.

You can see Closet Door here.

>nw
You can't go that way.

>n\
That's not a verb I recognise.

>w
SW Zone
In this side of the room there is a painting hanging and your friend is sleeping on the floor.

You can see Red Painting and Friend here.

* * *

>x painting
A large abstract red painting hanging slightly askew on the wall

>x painting
A large abstract red painting hanging slightly askew on the wall

>x friend
Your friend begrudgingly agreed to come along with you to do the escape room, but is spending most of the time sleeping on the floor. You'll need to WAKE him before he can help you.

>wake friend
You wake up your friend. He is now ready to help.

>e
SE Zone
In this side of the room there is a painting hanging and a small closet with an interesting locked door.

You can see Closet Door here.

>n
NE Zone
In this side of the room there is a painting hanging and the exit door, with its flashing keypad. (Examine the exit door to enter pin code)

You can see Exit Door and Wall Clock here.

>w
NW Zone
In this side of the room there is a desk with a small poster hanging above it

You can see Desk here.

You have 45 minutes left to break out!

>x Desk
There's not much on the desk surface other than a potted plant. The desk has a small drawer below it.

>open drawer
You open Desk Drawer, revealing Paperclip.

>take paper clip
You can't see any such thing.

>take paperclip
Taken.

* * *

>s
SW Zone
In this side of the room there is a painting hanging and your friend is sleeping on the floor.

You can see Red Painting and Friend here.

>e
SE Zone
In this side of the room there is a painting hanging and a small closet with an interesting locked door.

You can see Closet Door here.

>x closet door
An ordinary door leading to a small storage closet in the room. It's locked with one of those flimsy locks the criminals always pick.

>pick lock
I didn't understand that sentence.

>unfold paperclip
You unfold the paperclip in to a long, stiff wire, making it perfect to pick a door

>open lock
You can't see any such thing.

>open closet door lock
I only understood you as far as wanting to open Closet Door.

>open closet door
You use the long wire of the unfolded paperclip to pick the lock on the door. It clicks and the door is unlocked. 
You open Closet Door.

>s
Closet
A small closet with a few jackets hung on the bar

You can see Closet Door, Suede Jacket, Leather Jacket and Cotton Jacket here.

>x cotton jacket
A trendy white bomber jacket made out of cotton. There is a zipped pocket on the front of this jacket

>x pocket
You open the Jacket pocket, revealing Unidentified Key

>take key
Taken.

>s
You can't go that way.

>w
You can't go that way.

>n
SE Zone
In this side of the room there is a painting hanging and a small closet with an interesting locked door.

You can see Closet Door here.

You have 30 minutes left to break out!

>e
You can't go that way.

>unlock hidden door with unidentified key
You can't see any such thing.

>w
SW Zone
In this side of the room there is a painting hanging and your friend is sleeping on the floor.

You can see Red Painting and Friend here.

>unlock hidden door with key
You unlock Hidden Door.

>w
(first opening Hidden Door)

Hidden Room
A small dark room with only one thing in it. The computer sits on the floor, plugged in to the wall.

You can see Computer here.

>x computer
Logging in...
...
...
A line of numbers appears on the screen: {7692649}

>n
You can't go that way.

>w
You can't go that way.

>e
SW Zone
In this side of the room there is a painting hanging and your friend is sleeping on the floor.

You can see Red Painting and Friend here.

>n
NW Zone
In this side of the room there is a desk with a small poster hanging above it

You can see Desk here.

* * *

>x poster
The poster hangs above the desk and reads "ODD NUMBERS ARE A MYTH. Consider only using the even numbers"

>e
NE Zone
In this side of the room there is a painting hanging and the exit door, with its flashing keypad. (Examine the exit door to enter pin code)

You can see Exit Door and Wall Clock here.

>x exit door
The final door, leading to the lobby once you escape. It's a solid metal door with a keypad. Have you found the pin code?

Enter the 4 digit pin code to unlock door.

>6264
**BUZZ**  The door unlocks

>e
(first opening Exit Door)

Lobby
You can see Exit Door here.

Congrats! You open the door and escape in time!

    *** The End ***

Would you like to RESTART, RESTORE a saved game, QUIT or UNDO the last command?

* * *

>x painting
A large abstract blue painting hung solidly in place

You have 60 minutes to breakout! (Each turn is one minute. You will be reminded periodically of the time, or you can always examine the wall clock in the NE zone.)

>x exit door
The final door, leading to the lobby once you escape. It's a solid metal door with a keypad. Have you found the pin code?

Enter the 4 digit pin code to unlock door.

>x wall clock
Incorrect pin, Door remains locked.

Would you like to try again? (Yes or No)

>yes
Enter the 4 digit pin code to unlock door.

>S
Incorrect pin, Door remains locked.

Would you like to try again? (Yes or No)

* * *

>x closet
An ordinary door leading to a small storage closet in the room. It's locked with one of those flimsy locks the criminals always pick.

>w
SW Zone
In this side of the room there is a painting hanging and your friend is sleeping on the floor.

You can see Red Painting and Friend here.

>x red paionting
I only understood you as far as wanting to examine Red Painting.

>x red painting
A large abstract red painting hanging slightly askew on the wall

>x sleeping friend
You can't see any such thing.

>x friend
Your friend begrudgingly agreed to come along with you to do the escape room, but is spending most of the time sleeping on the floor. You'll need to WAKE him before he can help you.

>inventory
You are carrying nothing.

>n
NW Zone
In this side of the room there is a desk with a small poster hanging above it

You can see Desk here.

>x desk
There's not much on the desk surface other than a potted plant. The desk has a small drawer below it.

>x drawer
You see nothing special about Desk Drawer.

>x open drawer
You can't see any such thing.

>open desk drawer
You open Desk Drawer, revealing Paperclip.

>pick up paperclip[
Taken.

>s
SW Zone
In this side of the room there is a painting hanging and your friend is sleeping on the floor.

You can see Red Painting and Friend here.

* * *

>e
SE Zone
In this side of the room there is a painting hanging and a small closet with an interesting locked door.

You can see Closet Door here.

You have 45 minutes left to break out!

>unlock closet door
(with Paperclip)
That doesn't seem to fit the lock.

>unfold paperclip
You unfold the paperclip in to a long, stiff wire, making it perfect to pick a door

>unlock closet door
(with Paperclip)
That doesn't seem to fit the lock.

>inventory
You are carrying:
  Paperclip

>unfold paperclip
You unfold the paperclip in to a long, stiff wire, making it perfect to pick a door

>pick the lock
I didn't understand that sentence.

>open closet door
You use the long wire of the unfolded paperclip to pick the lock on the door. It clicks and the door is unlocked. 
You open Closet Door.

>x storage room
You can't see any such thing.

>x closet
An ordinary door leading to a small storage closet in the room. It's locked with one of those flimsy locks the criminals always pick.

>s
Closet
A small closet with a few jackets hung on the bar

You can see Closet Door, Suede Jacket, Leather Jacket and Cotton Jacket here.

>x leather jacket
An emo looking slick black leather jacket.

>x cotton jacket
A trendy white bomber jacket made out of cotton. There is a zipped pocket on the front of this jacket

* * *

>take key
Taken.

>inventory
You are carrying:
  Unidentified key
  Paperclip

>x suede jacket
A very fashionable blue suede jacket.

>n
SE Zone
In this side of the room there is a painting hanging and a small closet with an interesting locked door.

You can see Closet Door here.

You have 30 minutes left to break out!

>n
NE Zone
In this side of the room there is a painting hanging and the exit door, with its flashing keypad. (x Exit Door to enter pin code)

You can see Exit Door and Wall Clock here.

* * *

>w
NW Zone
In this side of the room there is a desk with a small poster hanging above it

You can see Desk here.

>x poster
The poster hangs above the desk and reads "ODD NUMBERS ARE A MYTH. Consider only using the even numbers"

>take poster
That's hardly portable.

>s
SW Zone
In this side of the room there is a painting hanging and your friend is sleeping on the floor.

You can see Red Painting and Friend here.

>x red painting
A large abstract red painting hanging slightly askew on the wall

>move painting
Nothing obvious happens.

>take p[ainting
You can't see any such thing.

>take painting
Taken.

>x hole
You can't see any such thing.

>x wall
You can't see any such thing.

>x painting
A large abstract red painting hanging slightly askew on the wall

>inventory
You are carrying:
  Red Painting
  Unidentified key
  Paperclip

>unlock hidden door with unidentified key
You unlock Hidden Door.

>w
(first opening Hidden Door)

Hidden Room
A small dark room with only one thing in it. The computer sits on the floor, plugged in to the wall.

You can see Computer here.

* * *

>x computer
Logging in...
...
...
A line of numbers appears on the screen: {7692649}

>s
You can't go that way.

>e
SW Zone
In this side of the room there is a painting hanging and your friend is sleeping on the floor.

You can see Friend here.

You have 15 minutes left to break out!

>e
SE Zone
In this side of the room there is a painting hanging and a small closet with an interesting locked door.

You can see Closet Door here.

>n
NE Zone
In this side of the room there is a painting hanging and the exit door, with its flashing keypad. (x Exit Door to enter pin code)

You can see Exit Door and Wall Clock here.

>x exit door
The final door, leading to the lobby once you escape. It's a solid metal door with a keypad. Have you found the pin code?

Enter the 4 digit pin code to unlock door.

* * *

>x painting
A large abstract blue painting hung solidly in place

You have 60 minutes to breakout! (Each turn is one minute. You will be reminded periodically of the time, or you can always examine the wall clock in the NE zone.)

>x keypad
You can't see any such thing.

>x wall clock
A digital clock showing the current time. You started the game at 9:00 am and have 60 minutes to escape. Remember that each turn is one minute.
it is currently 9:01 am

>e
(first opening Exit Door)
It seems to be locked.

>s
SE Zone
In this side of the room there is a painting hanging and a small closet with an interesting locked door.

You can see Closet Door here.

* * *

>x painting
A large abstract green painting hung solidly in place

>x closet door
An ordinary door leading to a small storage closet in the room. It's locked with one of those flimsy locks the criminals always pick.

>x self
As good-looking as ever.

>i
You are carrying nothing.

>s
(first opening Closet Door)
The door is locked. If only you had something to manipulate the lock open.

>w
SW Zone
In this side of the room there is a painting hanging and your friend is sleeping on the floor.

You can see Hidden Door, Red Painting and Friend here.

>x friend
Your friend begrudgingly agreed to come along with you to do the escape room, but is spending most of the time sleeping on the floor. He's probably only good for a minute or two of help. {NPC NOT YET FUNCTIONAL FOR BETA TEST}

>x red painting
A large abstract red painting hanging slightly askew on the wall

>straighten painting
I didn't understand that sentence.

>n
NW Zone
In this side of the room there is a desk with a small poster hanging above it

You can see Desk here.

>s
SW Zone
In this side of the room there is a painting hanging and your friend is sleeping on the floor.

You can see Hidden Door, Red Painting and Friend here.

* * *

>w
(first opening Hidden Door)
It seems to be locked.

>x hidden door
You see nothing special about Hidden Door.

You have 45 minutes left to break out!

>e
SE Zone
In this side of the room there is a painting hanging and a small closet with an interesting locked door.

You can see Closet Door here.

>w
SW Zone
In this side of the room there is a painting hanging and your friend is sleeping on the floor.

You can see Hidden Door, Red Painting and Friend here.

>n
NW Zone
In this side of the room there is a desk with a small poster hanging above it

You can see Desk here.

* * *

>x poster
The poster hangs above the desk and reads "ODD NUMBERS ARE A MYTH. Consider only using the even numbers"

>x desk
There's not much on the desk surface other than a potted plant. The desk has a small drawer below it.

>x plant
An insignificant succulant in a clay pot. It looks like it hasn't had water in a while.

>take plant
Taken.

>open drawer
You open Desk Drawer, revealing Paperclip.

* * *

>take paperclip
Taken.

>e
NE Zone
In this side of the room there is a painting hanging and the exit door, with its flashing keypad. (x Exit Door to enter pin code)

You can see Exit Door and Wall Clock here.

>s
SE Zone
In this side of the room there is a painting hanging and a small closet with an interesting locked door.

You can see Closet Door here.

>pick lock
I didn't understand that sentence.

>open door
The door is locked. If only you had something to manipulate the lock open.

>manipulate lock
That's not a verb I recognise.

>lockpick
That's not a verb I recognise.

>open closet door with paperclip
You unlock Closet Door.

>e
You can't go that way.

>s
(first opening Closet Door)
The door is locked. If only you had something to manipulate the lock open.

You have 30 minutes left to break out!

>unfold
I didn't understand that sentence.

>unfold paperclip
You unfold the paperclip in to a long, stiff wire, making it perfect to pick a door

>i
You are carrying:
  Paperclip
  Potted Plant

>open closet door
You use the long wire of the unfolded paperclip to pick the lock on the door. It clicks and the door is unlocked. 
You open Closet Door.

>e
You can't go that way.

>s
Closet
A small closet with a few jackets hung on the bar

You can see Closet Door, Suede Jacket, Leather Jacket and Cotten Jacket here.

>x jackets
You can't see any such thing.

>x jacket
Which do you mean, Suede Jacket, Leather Jacket, Cotten Jacket or Jacket pocket?

>x cotten jacket
A trendy white bomber jacket made out of cotten. There is a zipped pocket on the front of this jacket

>unzip pocket
I only understood you as far as wanting to unzip.

>x cotten jacket pocket
I only understood you as far as wanting to examine Cotten Jacket.

>x jacket pocket
You open the Jacket pocket, revealing Unidentified Key

>take key
Taken.

>w
You can't go that way.

>e
You can't go that way.

>n
SE Zone
In this side of the room there is a painting hanging and a small closet with an interesting locked door.

You can see Closet Door here.

>w
SW Zone
In this side of the room there is a painting hanging and your friend is sleeping on the floor.

You can see Hidden Door, Red Painting and Friend here.

>open hidden door
It seems to be locked.

>unlock hidden door with key
You unlock Hidden Door.

>n
NW Zone
In this side of the room there is a desk with a small poster hanging above it

You can see Desk here.

You have 15 minutes left to break out!

>s
SW Zone
In this side of the room there is a painting hanging and your friend is sleeping on the floor.

You can see Hidden Door, Red Painting and Friend here.

>e
SE Zone
In this side of the room there is a painting hanging and a small closet with an interesting locked door.

You can see Closet Door here.

* * *

>w
SW Zone
In this side of the room there is a painting hanging and your friend is sleeping on the floor.

You can see Hidden Door, Red Painting and Friend here.

>w
(first opening Hidden Door)

Hidden Room
You can see Hidden Door and Computer here.

>x computer
Logging in...
...
...
A line of numbers appears on the screen: {7692649}

>799
That's not a verb I recognise.

>take computer
Taken.

>s
You can't go that way.

>e
SW Zone
In this side of the room there is a painting hanging and your friend is sleeping on the floor.

You can see Hidden Door, Red Painting and Friend here.

>e
SE Zone
In this side of the room there is a painting hanging and a small closet with an interesting locked door.

You can see Closet Door here.

>e
You can't go that way.

The big wall clock begins its 5 minute countdown

>n
NE Zone
In this side of the room there is a painting hanging and the exit door, with its flashing keypad. (x Exit Door to enter pin code)

You can see Exit Door and Wall Clock here.

The big wall clock reads 4 minutes remaining

>x exit door
A solid metal door and keypad. Have you found the pin code?

The big wall clock reads 3 minutes remaining
Enter the 4 digit pin code to unlock door.

>6264
**BUZZ**  The door unlocks

* * *

>x picture
You can't see any such thing.

>x painting
A large abstract blue painting hung solidly in place

You have 60 minutes to breakout! (Each turn is one minute)

>e
(first opening Exit Door)
It seems to be locked.

>w
NW Zone
In this side of the room there is a desk with a small poster hanging above it

You can see Desk here.

* * *

>x poster
The poster hangs above the desk and reads "ODD NUMBERS ARE A MYTH. Consider only using the even numbers"

>x desk
There's not much on the desk surface other than a lamp. The desk has a small drawer below it.

>open drawer
You open Desk Drawer, revealing Paperclip.

* * *

>take paperclip
Taken.

>x paperclip
A normally folded paperclip. Perfectly capable of being unfolded.

>unfold paperclip
You unfold the paperclip in to a long, stiff wire, making it perfect to pick a door

>unfold paperclip
You unfold the paperclip in to a long, stiff wire, making it perfect to pick a door

* * *

>s
SW Zone
In this side of the room there is a painting hanging and your friend is sleeping on the floor.

You can see Hidden Door and Friend here.

>w
(first opening Hidden Door)

Hidden Room
You can see Hidden Door and Computer (closed) here.

>e
SW Zone
In this side of the room there is a painting hanging and your friend is sleeping on the floor.

You can see Hidden Door and Friend here.

>e
SE Zone
In this side of the room there is a painting hanging and a small closet with an interesting locked door.

>open closet door
You can't see any such thing.

>open closet door
You can't see any such thing.

>enter closet
You can't see any such thing.

>x closet
You can't see any such thing.

>enter closet
You can't see any such thing.

>x closet door
You can't see any such thing.

* * *

>x self
You're a high school kid with one of your friends out for a good Friday night. Too bad your friend is tired. You're wearing jeans with an olive green oxford style shirt.

You have 60 minutes to breakout! (Each turn is one minute. You will be reminded periodically of the time, or you can always examine the wall clock in the NE zone.)

* * *

>x wall clock
A digital clock showiung the time you have remaining to escape. Remember that each turn is one minute.
9:00 am
You have 60 minutes to breakout! (Each turn is one minute)